11 5 5 5 5 5 5 5 5 3 10 1 5 5 15 5 5 5 5 5 3 10 1 5 5 5 5 5 12 
6 10 10 10 21 22 10 10 10 10 10 10 10 37 6 10 10 10 10 10 10 10 10 10 10 10 10 40 6 
6 10 2 10 24 23 10 1 15 5 3 10 9 10 6 10 1 3 10 1 5 5 5 5 5 5 3 10 6 
6 10 4 10 10 10 10 10 6 10 10 10 10 10 6 10 10 10 10 10 10 10 10 10 10 10 10 10 6 
6 10 10 10 1 5 12 10 6 10 11 5 3 10 18 5 5 5 5 3 10 1 5 5 5 5 5 5 16 
6 21 22 10 10 10 6 10 4 10 4 10 10 10 6 10 10 10 10 10 10 10 10 10 10 10 10 10 6 
6 28 26 10 2 10 4 36 10 10 10 10 21 22 6 10 1 5 5 5 5 5 3 35 1 5 3 10 6 
6 24 23 10 6 10 10 10 11 5 3 10 24 23 6 10 10 10 10 10 10 10 10 10 10 10 10 10 6 
6 10 10 10 14 5 3 10 4 10 10 10 10 35 18 5 3 10 1 5 5 5 5 5 5 5 5 5 16 
6 10 2 10 10 10 10 10 10 10 21 25 22 10 6 10 10 10 10 10 10 10 10 10 10 10 10 10 6 
4 10 14 5 5 5 3 10 2 10 24 27 23 10 6 10 1 5 5 5 5 3 10 1 5 5 3 10 4 
10 10 10 10 10 10 10 10 6 10 10 10 10 38 6 39 10 10 10 10 10 10 10 10 10 10 10 10 10 
11 5 5 5 5 5 15 5 17 5 5 5 5 5 19 5 5 5 5 5 5 5 15 5 5 5 5 5 12 
6 37 10 10 10 10 6 10 10 10 10 10 10 10 6 21 22 37 10 10 10 10 4 10 10 10 21 22 6 
6 10 2 10 9 10 4 10 9 10 2 10 9 10 6 24 23 10 2 10 2 10 10 10 2 10 24 23 6 
6 10 6 10 10 10 10 10 10 10 6 10 10 10 6 10 10 10 6 10 14 5 12 10 6 10 10 10 6 
4 10 14 15 3 10 1 5 3 10 14 15 3 10 6 10 2 10 6 10 10 10 4 10 14 5 3 10 4 
10 10 10 6 10 10 10 10 10 10 10 6 10 35 6 10 6 10 4 10 2 10 10 10 10 10 10 10 10 
11 3 10 4 10 9 10 2 10 2 10 4 10 1 16 10 10 10 10 10 4 35 1 5 5 5 12 10 2 
6 10 10 10 10 10 10 4 10 4 10 10 10 10 6 10 6 10 2 10 10 10 10 10 10 10 6 10 6 
18 5 5 3 10 2 10 10 10 10 10 21 22 10 6 10 4 10 6 10 1 5 5 5 12 10 4 10 6 
6 10 10 10 10 18 3 10 1 12 10 28 26 10 6 10 10 10 6 10 10 10 10 10 6 10 10 10 6 
6 10 1 3 10 4 10 10 10 4 10 24 23 10 6 21 22 10 14 5 3 10 2 10 4 10 21 22 6 
6 10 10 10 10 10 10 2 10 10 10 10 10 39 6 24 23 10 10 10 10 10 6 10 10 40 24 23 6 
14 5 5 5 5 5 5 17 5 3 10 1 5 5 17 5 5 5 5 5 3 10 14 5 5 5 5 5 13 
-
