11 5 5 5 5 5 5 5 5 5 5 5 5 5 5 5 5 5 5 12 
6 35 10 10 10 10 10 10 10 10 10 10 10 10 10 10 10 10 35 6 
6 10 21 25 25 22 10 2 10 21 22 10 2 10 21 25 25 22 10 6 
6 10 24 27 27 23 10 4 10 24 23 10 4 10 24 27 27 23 10 6 
6 10 10 10 10 10 10 10 37 10 10 10 10 10 10 10 10 10 10 6 
6 10 9 10 1 5 15 3 10 1 3 10 1 15 5 3 10 9 10 6 
6 10 10 10 10 10 6 10 10 10 10 10 10 6 10 10 10 10 10 6 
6 10 1 5 3 10 4 10 1 5 5 3 10 4 10 1 5 3 10 6 
6 10 10 10 10 10 10 10 10 10 10 10 10 10 10 10 10 10 39 6 
6 10 21 22 10 1 12 10 1 25 25 3 10 11 3 10 21 22 10 6 
6 10 28 26 10 10 6 10 10 24 23 10 10 6 10 10 28 26 10 6 
6 10 28 32 22 10 28 22 10 10 10 10 21 26 10 21 31 26 10 6 
6 10 24 27 23 10 24 23 10 1 3 10 24 23 10 24 27 23 10 6 
6 10 10 10 10 10 10 10 10 36 10 10 10 10 10 10 10 10 10 6 
6 10 1 5 15 5 3 10 1 5 5 3 10 1 5 15 5 3 10 6 
6 38 10 10 4 10 10 10 10 10 10 10 10 10 10 4 10 10 10 6 
6 10 2 10 10 10 21 22 10 21 22 10 21 22 10 10 10 2 10 6 
6 10 4 10 1 5 27 23 10 24 23 10 24 27 5 3 10 4 10 6 
6 35 10 10 10 10 40 10 10 10 10 10 10 10 10 10 10 10 35 6 
14 5 5 5 5 5 5 5 5 5 5 5 5 5 5 5 5 5 5 13 
-
