20 20 20 20 20 20 20 20 7 9 9 9 9 9 9 7 20 20 20 20 20 20 20 20 
20 20 20 20 20 20 9 9 10 10 10 10 10 20 20 10 9 9 20 20 20 20 20 20 
20 20 20 20 9 9 10 10 10 20 10 20 10 10 20 10 10 10 9 20 20 20 20 20 
20 20 20 9 20 20 10 20 20 20 10 20 20 10 20 10 20 10 10 9 20 20 20 20 
20 20 9 20 20 10 10 10 10 10 10 10 20 10 10 10 20 20 10 20 9 20 20 20 
20 20 9 20 9 7 9 20 10 20 20 10 10 10 9 7 9 20 10 10 10 9 20 20 
20 9 20 9 10 10 37 9 10 10 10 10 20 9 10 10 38 9 10 20 10 10 9 20 
20 9 9 10 10 20 10 9 20 20 10 20 9 20 10 20 10 9 10 10 20 10 9 20 
9 20 9 10 20 20 10 20 9 20 10 20 9 20 10 20 10 10 9 10 10 10 10 9 
9 10 8 10 10 35 10 10 10 8 36 8 10 10 10 35 20 10 8 10 20 20 10 9 
9 10 9 10 20 20 10 20 9 20 10 20 9 10 20 10 10 10 9 10 10 20 10 9 
9 10 9 10 20 20 10 20 9 10 10 10 9 10 20 20 10 20 9 20 10 10 10 9 
8 10 9 40 10 10 10 9 10 10 20 10 9 39 10 10 10 9 20 20 10 20 10 8 
9 10 20 9 20 20 7 9 10 20 20 10 20 9 20 20 7 9 20 20 10 20 20 9 
9 10 10 10 9 9 10 10 10 20 10 10 10 10 9 9 10 20 10 10 10 10 10 9 
9 10 20 10 10 10 10 20 10 10 10 20 20 10 10 10 10 10 10 20 20 20 10 9 
9 10 20 10 20 20 10 20 20 10 20 20 20 10 20 20 20 10 20 20 20 20 10 9 
9 10 10 10 10 10 10 20 10 10 10 10 10 10 10 10 20 10 10 10 10 10 10 9 
9 10 20 20 10 20 10 35 10 20 10 20 20 10 20 10 35 10 20 10 20 20 10 9 
9 10 20 10 10 10 20 20 20 20 10 10 10 10 20 20 20 20 10 10 10 20 10 9 
9 10 10 10 9 10 10 20 20 10 10 9 9 10 10 20 20 10 10 9 10 10 10 9 
9 20 20 9 20 9 10 10 10 10 9 20 20 9 10 10 10 10 9 20 9 20 20 9 
9 20 9 20 20 20 9 20 10 9 20 20 20 20 9 10 20 9 20 20 20 9 20 9 
9 9 20 20 20 20 20 9 7 20 20 20 20 20 20 7 9 20 20 20 20 20 9 9 
-
