11 5 5 5 5 5 5 5 5 5 5 5 5 5 5 5 5 5 5 5 5 5 5 5 5 5 5 5 5 5 5 5 5 5 5 5 5 5 5 5 5 5 5 5 5 5 5 5 5 5 5 5 5 5 5 5 5 5 5 5 5 5 5 5 5 5 5 5 5 5 5 5 5 5 5 5 5 5 5 5 5 5 5 5 5 5 5 5 5 5 12 
6 10 10 10 10 10 10 10 10 10 10 10 35 10 10 10 10 41 10 9 10 10 10 10 10 41 10 10 10 10 10 10 10 10 10 10 10 10 10 10 10 10 10 10 10 10 10 10 10 10 10 10 10 10 10 10 10 10 10 10 10 10 10 10 10 10 10 10 10 10 10 10 10 10 10 10 10 10 10 10 10 10 10 10 10 10 10 10 10 10 6 
6 10 10 10 10 41 35 10 10 10 10 10 10 10 10 9 10 10 10 10 10 10 10 10 10 10 10 10 10 10 10 10 10 10 10 10 10 10 10 10 10 10 10 10 10 10 10 10 10 10 10 10 10 10 10 10 10 10 10 10 10 10 10 10 10 10 10 10 10 10 10 10 10 10 10 10 10 10 10 10 10 10 10 10 10 10 10 10 10 10 6 
6 10 10 10 10 41 10 10 10 10 10 10 10 10 10 10 10 10 10 35 10 10 10 10 10 10 35 10 10 10 41 35 10 10 10 10 10 10 10 10 10 10 10 10 10 10 10 10 10 10 10 10 10 10 35 35 10 10 35 10 41 10 10 10 10 10 10 10 10 10 10 10 10 10 10 10 10 10 10 10 10 10 10 10 10 10 10 10 10 10 6 
6 10 10 10 10 10 10 10 10 10 10 9 10 10 10 10 10 10 10 10 10 10 10 10 10 10 10 10 10 10 41 10 10 10 10 10 10 10 10 10 10 10 10 10 10 10 10 10 10 10 10 10 10 10 10 10 35 10 10 10 10 10 10 10 10 10 10 10 10 10 10 10 35 10 35 10 10 10 10 10 10 10 10 10 10 10 10 10 10 10 6 
41 10 10 10 10 10 10 10 10 10 10 10 10 35 35 35 10 10 10 10 10 35 10 10 10 10 10 9 10 10 10 10 10 10 10 10 10 10 10 10 35 10 10 10 10 10 10 10 10 41 10 10 10 10 10 10 10 10 10 10 10 10 10 10 41 10 10 10 10 10 10 10 35 10 10 10 10 10 10 10 35 10 10 10 10 10 10 10 10 10 6 
6 10 10 10 10 10 10 10 10 10 41 10 41 9 35 10 10 35 10 10 10 10 10 35 10 10 10 10 10 10 10 10 35 10 10 10 10 10 10 10 10 35 10 36 35 10 10 10 41 10 10 10 10 10 10 10 10 10 10 10 10 10 35 41 41 10 10 10 35 10 10 10 35 10 10 10 10 10 10 10 10 10 10 10 10 10 10 10 10 10 6 
6 10 10 10 10 10 10 10 10 10 10 35 35 10 10 35 10 9 10 10 10 10 10 10 10 10 10 41 10 10 10 35 41 35 10 10 10 10 10 36 10 35 35 41 9 35 10 10 36 10 10 10 10 10 10 10 10 10 10 10 10 41 10 10 10 10 10 9 10 10 10 10 10 10 10 10 10 10 10 10 10 10 10 10 10 35 10 10 10 10 6 
6 10 10 10 10 35 35 10 10 10 35 10 10 10 35 10 10 10 10 35 35 35 10 10 10 10 10 10 10 10 10 36 10 10 10 35 10 10 10 10 41 10 35 35 10 10 10 10 10 10 10 35 10 10 10 10 41 10 10 10 10 10 10 10 10 10 10 10 10 10 10 10 10 10 10 10 10 10 10 10 10 10 10 10 10 10 10 10 10 10 6 
6 10 10 10 10 10 10 10 10 35 9 10 10 10 35 10 10 10 10 10 10 41 10 35 10 35 35 10 10 10 36 10 10 9 10 10 10 10 10 10 36 10 35 10 10 10 10 10 10 10 10 10 36 10 10 10 10 10 10 10 10 10 10 10 10 10 10 10 10 35 10 41 10 10 10 10 10 10 10 10 10 10 10 10 10 10 10 10 10 10 6 
6 10 10 10 10 10 10 10 10 35 9 35 10 10 10 10 35 10 9 10 10 41 9 10 10 10 10 10 10 36 10 10 10 10 10 10 35 10 10 35 10 10 10 10 10 10 35 10 35 10 10 10 10 35 35 35 10 35 10 10 10 10 10 10 10 10 10 10 10 10 10 10 10 35 35 10 10 10 10 10 10 9 10 10 10 10 10 10 35 10 6 
6 10 10 35 10 10 10 10 10 10 10 10 10 10 10 10 10 10 10 10 10 35 10 35 10 10 10 10 10 10 36 36 35 36 36 10 10 10 10 10 10 41 10 10 10 10 35 10 10 10 10 10 10 10 35 10 10 10 10 35 10 35 35 36 10 10 10 10 10 10 41 10 10 41 10 10 10 10 10 10 10 10 10 10 10 10 10 35 10 10 6 
6 10 10 10 10 10 10 10 10 10 10 9 10 10 10 10 35 10 10 10 10 36 10 41 10 10 41 36 10 10 10 35 10 36 9 10 36 10 36 10 41 10 10 9 10 10 41 10 10 10 10 10 10 10 10 10 10 10 35 10 35 10 10 35 10 10 10 10 10 10 10 10 10 10 10 10 10 35 10 35 10 35 10 10 10 10 10 10 10 10 6 
6 10 10 10 10 10 10 10 10 9 10 10 10 10 10 9 10 10 10 9 10 10 41 36 10 10 35 35 35 36 9 10 10 10 10 10 10 10 10 36 9 36 10 10 10 10 10 10 10 10 10 10 10 10 10 10 10 10 10 10 10 35 10 35 10 10 10 10 10 41 10 10 10 10 10 35 10 10 10 10 10 10 10 10 10 10 10 10 10 10 6 
6 10 10 10 10 10 10 35 10 10 10 10 10 10 10 10 10 10 10 10 10 36 35 35 10 10 10 10 10 10 10 10 41 10 10 10 10 41 36 10 36 10 10 10 36 10 10 10 10 10 10 10 10 35 10 10 10 10 10 35 35 35 10 10 10 10 10 41 35 10 35 10 10 10 10 41 35 10 10 10 10 10 10 10 10 10 35 10 10 10 6 
6 10 35 10 10 10 10 10 10 10 10 10 35 9 36 10 10 10 10 10 10 10 36 10 10 10 10 10 35 10 10 10 10 36 10 10 10 10 10 10 10 10 35 36 10 35 10 10 10 10 41 35 10 36 36 10 35 36 10 10 10 10 10 10 10 10 10 10 41 10 10 10 35 36 10 35 10 10 10 10 10 10 10 10 10 10 10 10 10 10 6 
6 10 10 10 35 10 10 10 10 10 10 10 36 10 10 10 10 10 10 10 10 10 10 10 9 10 41 9 41 10 9 35 10 10 41 10 10 10 41 10 9 36 36 10 10 10 10 35 10 10 10 10 10 10 41 10 10 10 10 10 10 36 10 10 36 10 10 10 10 10 10 10 10 35 41 35 10 10 35 10 10 10 9 10 10 10 10 10 10 10 35 
6 10 10 10 10 10 10 10 10 10 10 10 9 10 10 10 35 10 10 36 10 41 10 10 10 10 35 10 10 10 10 10 10 10 10 10 10 9 10 9 10 10 41 36 10 35 10 10 41 35 36 10 10 10 10 9 10 10 10 10 35 10 10 10 10 10 10 10 10 10 10 10 10 35 10 10 10 35 35 10 10 10 10 10 10 10 10 10 10 10 6 
6 10 10 10 10 10 9 10 10 10 10 35 10 10 10 10 10 10 10 10 9 10 10 10 10 10 36 9 10 36 10 10 10 10 10 10 10 10 10 10 35 10 10 36 10 10 10 36 41 10 10 10 10 36 10 10 10 10 10 10 10 9 10 10 36 41 10 9 35 10 10 10 10 35 10 10 10 10 10 10 10 10 10 10 10 10 10 10 10 10 6 
6 10 10 10 10 10 10 35 10 10 10 10 10 10 35 36 10 10 10 36 9 10 36 36 41 35 9 10 9 10 10 10 36 10 10 10 10 35 10 10 10 10 10 36 10 10 10 10 10 10 10 10 10 10 10 10 10 10 10 10 10 10 10 10 10 10 10 10 10 10 10 10 10 10 10 10 10 35 10 10 10 10 10 10 10 10 10 10 10 10 6 
6 10 10 10 10 10 10 10 35 10 36 10 10 10 10 10 9 10 35 36 9 10 36 10 10 35 10 10 10 10 41 36 10 10 35 9 41 10 10 10 10 10 9 10 10 10 10 10 10 36 10 36 10 10 10 10 10 10 41 10 10 10 10 10 10 10 10 10 10 10 10 35 9 10 10 10 35 10 10 10 10 10 10 10 10 10 10 10 10 10 6 
6 10 10 10 10 10 10 10 10 10 36 10 9 9 10 9 10 36 10 10 10 10 10 35 36 10 9 35 10 10 10 10 10 36 10 10 10 10 41 10 9 10 10 10 36 10 36 10 10 10 10 35 10 10 10 10 10 10 10 10 10 10 10 9 10 10 10 10 35 10 10 10 10 10 10 10 35 10 10 35 10 10 35 10 10 10 10 35 10 10 6 
6 10 10 10 10 10 10 10 10 10 10 10 10 10 35 10 36 10 10 10 10 10 10 36 35 10 36 10 10 10 10 10 35 35 10 10 36 10 10 9 9 10 10 10 41 10 10 41 10 10 10 36 10 36 10 10 10 10 35 10 10 10 10 10 10 41 10 41 10 35 10 10 10 10 10 9 10 10 10 10 36 10 10 10 10 10 10 10 10 10 6 
6 10 10 10 10 10 10 10 10 10 10 10 10 41 10 10 9 10 35 36 10 10 41 10 10 10 10 10 10 9 10 10 10 10 9 10 10 10 10 36 10 10 10 10 36 36 10 10 10 9 10 10 10 10 36 10 41 10 36 41 10 10 10 10 10 10 41 10 10 35 10 10 10 10 10 10 10 10 10 10 10 10 10 10 10 10 10 10 10 10 6 
6 10 10 10 10 10 10 10 10 10 10 10 36 10 10 10 36 10 10 10 10 10 41 10 10 10 10 10 10 10 10 10 36 10 10 10 10 10 9 10 10 10 10 9 36 10 10 10 10 10 10 10 10 10 9 10 41 10 10 9 10 10 10 10 10 10 10 10 10 10 41 10 10 10 41 10 10 10 10 10 41 10 10 10 10 10 41 10 10 10 6 
6 10 10 10 9 10 10 10 10 10 10 10 35 10 10 10 10 10 10 36 10 10 10 10 10 10 36 36 10 35 10 10 10 36 10 35 10 36 10 36 10 10 10 10 10 10 10 10 36 9 10 10 35 10 10 10 41 10 10 10 10 10 10 10 10 9 41 10 10 10 10 10 36 10 10 10 10 10 10 10 10 10 10 10 10 10 41 10 10 10 6 
6 10 10 10 10 10 41 10 10 10 10 10 10 10 10 10 36 9 10 9 10 10 10 10 10 10 9 10 10 10 10 10 10 10 10 10 10 9 10 10 10 10 10 36 10 10 10 10 36 10 10 10 10 10 10 10 10 36 10 10 10 10 35 10 35 10 10 9 36 10 10 10 10 10 10 10 10 10 36 10 10 10 10 10 10 10 10 10 10 10 6 
6 35 41 10 35 10 10 10 10 35 10 10 41 10 10 10 10 10 10 10 36 9 10 10 10 10 10 10 10 10 10 10 10 10 10 9 10 9 9 10 10 10 36 10 10 9 10 10 10 10 10 10 9 10 10 35 10 10 10 10 10 10 10 10 10 10 9 9 10 10 10 10 10 10 10 10 10 10 10 41 10 10 10 10 10 10 10 10 10 10 6 
6 10 10 10 10 10 10 10 10 10 10 10 36 9 10 41 10 36 10 10 41 36 36 10 10 10 10 10 10 10 10 9 10 10 10 10 36 10 10 10 36 10 10 10 10 36 10 10 10 9 10 10 35 10 10 36 41 41 10 10 41 9 10 10 41 10 10 10 41 10 10 10 10 10 10 36 10 10 10 10 10 35 10 10 10 10 10 10 10 10 6 
35 10 10 10 10 10 9 10 10 10 10 10 10 10 10 10 35 10 10 10 10 35 10 10 36 10 10 10 10 36 9 10 10 10 10 36 10 10 36 9 10 36 41 36 10 10 10 10 10 10 36 10 36 10 10 9 10 10 10 10 10 10 10 10 10 10 10 10 10 10 41 10 10 10 10 10 10 9 10 10 10 10 10 35 35 10 10 10 10 10 6 
6 10 10 10 10 10 10 10 10 10 10 10 10 10 10 10 10 10 10 10 10 10 36 10 10 10 10 36 10 10 10 36 10 10 36 10 9 10 35 10 10 41 10 10 10 35 10 36 10 41 10 10 10 10 10 10 10 10 10 10 10 10 10 10 10 36 10 41 10 10 10 10 10 10 10 10 36 10 10 10 10 10 35 10 10 10 10 10 10 10 6 
35 10 10 10 10 41 10 10 10 10 10 10 10 10 35 10 10 10 36 10 10 10 10 10 10 10 10 35 10 10 10 10 10 10 10 10 10 10 10 10 10 10 36 10 9 10 41 10 10 10 10 10 9 10 10 10 10 10 9 9 10 10 10 41 10 10 10 10 10 10 41 41 10 10 10 10 10 10 10 10 10 41 10 10 10 10 10 10 10 10 6 
6 10 10 10 10 10 10 10 10 10 10 10 10 10 9 10 10 10 10 10 10 41 10 10 10 10 10 36 10 35 10 10 36 10 10 10 36 41 10 10 10 10 35 9 36 36 10 10 10 10 10 10 10 10 36 10 36 10 10 10 41 10 9 41 10 41 10 10 10 10 10 10 10 10 10 10 10 10 10 41 10 10 10 41 10 10 10 10 10 10 6 
6 10 10 10 10 10 10 10 10 10 10 10 10 10 10 10 10 10 36 10 10 10 10 10 10 10 10 10 10 10 10 41 10 10 10 9 10 41 10 10 10 10 36 10 10 10 10 10 10 10 41 10 10 10 10 10 10 10 9 10 41 10 10 10 10 10 10 41 10 10 10 10 10 10 10 10 36 10 10 10 10 10 10 10 10 10 10 10 10 10 6 
6 10 10 10 10 10 41 10 10 10 10 10 10 10 10 10 10 10 10 10 36 10 36 10 10 10 41 10 10 10 10 10 10 10 10 10 10 10 10 9 10 10 36 10 10 36 10 36 10 10 10 9 10 10 10 10 10 10 10 36 10 10 10 10 10 10 41 10 41 10 10 10 10 10 9 10 10 10 10 10 10 10 10 10 10 10 10 35 10 10 6 
6 10 10 10 10 10 10 35 10 10 10 10 10 10 41 10 36 10 10 10 10 36 41 10 9 9 10 35 10 10 36 41 10 41 10 10 10 10 10 10 10 10 9 10 10 41 10 10 9 36 10 10 10 10 10 35 10 41 41 10 10 10 36 36 10 10 10 10 10 10 10 10 9 10 10 10 36 10 10 10 41 10 10 10 10 10 10 10 10 10 6 
6 10 10 10 10 10 10 10 10 10 10 10 10 10 10 35 10 10 10 10 10 10 10 10 10 10 10 10 10 36 10 10 10 10 10 10 10 10 10 9 36 10 10 10 36 10 10 10 10 10 10 10 36 10 10 10 10 10 10 10 9 10 41 10 41 10 10 10 10 10 10 10 10 10 36 10 10 10 10 10 10 10 10 10 10 10 10 10 10 10 6 
6 10 10 35 10 10 10 10 10 10 10 10 10 10 10 10 10 10 10 10 10 10 36 10 41 35 10 10 10 10 10 10 10 10 10 10 10 10 10 10 36 10 10 10 36 36 10 10 36 10 41 10 10 10 10 10 10 10 10 41 36 9 10 10 10 41 10 10 10 10 10 10 36 10 10 10 10 10 10 10 10 10 10 9 10 10 10 10 10 10 6 
6 10 10 10 10 10 10 10 10 10 10 10 10 10 10 10 10 10 41 10 10 36 35 36 41 10 10 10 10 10 10 10 10 10 10 10 9 10 10 10 10 10 10 10 35 10 36 41 10 10 10 10 10 41 10 10 10 41 10 10 10 10 10 10 10 10 10 10 41 10 10 10 10 10 9 10 10 10 10 10 10 10 10 10 10 10 10 10 10 10 6 
6 10 10 10 10 10 10 10 10 10 10 10 10 10 10 10 10 10 10 9 10 10 10 10 10 10 10 10 10 10 10 10 36 10 36 36 10 41 41 10 10 10 10 10 36 10 10 10 10 36 10 41 10 10 10 10 9 10 10 10 9 10 10 41 10 10 10 36 10 10 10 10 10 41 10 10 10 10 10 10 10 10 10 10 10 10 10 10 10 10 6 
6 10 10 10 10 10 10 10 10 10 10 10 10 10 10 10 10 10 10 10 10 10 10 10 10 10 36 10 10 10 10 10 10 10 10 10 10 41 10 10 10 10 10 10 36 10 10 10 10 10 10 9 36 10 10 10 41 10 9 10 10 10 36 35 10 10 10 10 10 10 10 35 10 10 10 10 10 10 10 10 10 10 10 10 10 35 10 10 35 10 6 
6 10 10 10 10 10 35 10 10 10 10 10 10 10 10 10 10 10 10 10 10 10 10 10 35 10 36 10 10 10 10 10 10 10 10 10 10 10 9 10 10 10 10 36 36 10 9 10 10 10 10 10 10 9 10 41 10 10 10 10 9 10 10 10 10 9 10 41 10 41 9 10 10 10 10 35 10 10 10 35 10 10 10 10 10 10 10 10 10 10 6 
6 10 41 10 10 10 10 10 10 10 10 10 10 10 41 10 10 10 35 41 41 10 10 35 10 9 10 10 10 10 10 36 10 10 10 10 35 10 10 10 10 10 41 36 10 10 10 41 10 35 10 10 10 10 10 10 10 9 10 10 10 10 10 10 41 10 10 10 10 10 10 10 10 10 35 35 10 10 10 10 10 10 10 10 10 10 10 10 10 10 6 
6 10 10 10 10 10 10 35 10 10 10 10 10 35 35 10 10 10 10 10 10 10 10 10 10 10 10 10 10 10 10 10 10 10 9 36 36 10 41 41 10 36 10 9 10 10 10 10 10 10 10 10 10 10 10 10 10 10 10 10 10 10 10 10 35 10 10 10 10 10 10 10 10 9 10 10 10 10 10 10 10 10 10 35 10 10 10 10 10 10 6 
6 10 10 10 10 10 10 10 10 10 10 10 35 10 10 10 10 10 10 41 10 10 10 10 9 10 10 10 41 10 10 10 10 10 10 10 10 10 10 10 10 10 35 10 10 10 10 10 41 41 10 10 10 10 10 10 9 10 10 10 10 10 10 10 10 10 10 10 10 10 10 10 10 10 10 10 10 10 10 10 10 10 10 10 10 10 10 10 10 10 6 
6 10 10 10 10 10 10 10 10 35 10 10 10 10 10 10 10 10 10 10 10 10 10 35 10 10 10 10 10 10 10 10 10 10 10 10 10 10 10 10 10 10 10 35 10 10 10 10 10 10 36 10 10 10 10 10 10 10 10 10 10 10 10 10 10 10 10 10 10 10 10 10 10 10 10 10 10 35 10 10 10 10 10 10 10 10 10 35 10 35 6 
6 10 10 10 10 10 35 10 10 10 10 10 10 10 10 10 10 41 10 10 10 10 10 10 10 10 10 10 10 10 10 10 10 10 41 10 10 10 10 10 10 10 10 10 9 10 10 10 10 10 9 10 10 10 9 10 10 35 10 41 10 10 10 10 10 10 10 10 10 10 10 10 10 10 10 10 10 10 10 10 10 10 9 10 35 10 10 10 10 10 6 
6 10 41 10 10 10 10 10 10 10 10 10 10 10 10 10 10 10 41 10 10 10 10 10 10 10 10 10 10 10 10 10 10 10 10 41 10 10 41 10 10 35 35 10 10 10 10 10 10 10 10 10 10 10 10 10 10 10 10 10 10 10 10 10 10 10 10 10 35 10 10 10 10 10 10 10 10 10 10 10 10 10 10 10 10 10 10 10 10 10 6 
6 10 10 10 10 10 10 10 10 10 10 10 10 10 10 10 10 10 10 35 10 10 10 10 10 10 10 10 9 10 10 10 10 10 10 10 10 10 36 10 10 35 10 10 10 36 10 10 10 10 10 10 10 10 10 10 10 10 10 10 10 10 10 10 10 10 10 10 10 10 10 10 10 10 10 10 10 10 10 10 10 10 10 10 10 10 10 10 10 10 6 
6 10 10 10 10 35 10 10 10 10 10 10 10 10 10 10 10 10 10 10 10 10 10 10 10 10 10 10 10 10 10 10 10 10 10 9 10 41 10 35 36 10 36 10 10 10 10 9 10 10 10 10 10 10 10 10 9 10 10 10 10 35 10 10 10 10 10 10 10 10 10 10 10 10 10 10 10 10 10 10 10 10 10 10 10 10 10 10 10 10 6 
6 10 10 10 35 10 35 10 41 10 10 10 10 10 35 10 10 10 10 10 10 10 41 10 10 10 10 10 10 10 10 10 10 10 10 10 10 10 10 10 41 10 10 10 10 10 10 41 10 10 10 35 10 10 10 10 10 10 10 10 10 10 10 10 10 10 10 10 10 10 10 10 10 10 10 10 10 10 10 10 10 10 10 35 10 10 10 10 10 10 6 
6 10 10 10 10 10 10 10 10 10 10 10 10 10 10 10 10 10 10 10 10 10 10 10 10 10 10 10 10 10 10 10 10 10 10 10 10 10 10 10 10 10 10 10 10 10 10 10 10 10 35 35 10 10 10 10 10 10 10 10 9 10 10 10 10 10 10 10 9 10 10 10 10 10 10 35 10 10 10 10 10 10 10 10 10 10 10 10 10 10 6 
6 10 10 10 10 10 10 10 10 10 10 10 10 10 10 10 10 10 10 10 10 10 10 10 10 10 10 10 10 10 10 10 10 10 10 10 10 10 10 10 10 10 10 10 10 10 10 10 10 10 10 10 10 10 10 10 10 10 10 10 10 10 10 10 10 10 10 10 10 10 10 10 10 10 10 10 10 10 10 10 10 10 10 10 10 10 10 10 10 10 6 
14 5 5 5 5 5 5 5 5 5 5 5 5 5 5 5 5 5 5 5 5 5 5 5 5 5 5 5 5 5 5 5 5 5 5 5 5 5 5 5 5 5 5 5 5 5 5 5 5 5 5 5 5 5 5 5 5 5 5 5 5 5 5 5 5 5 5 5 5 5 5 5 5 5 5 5 5 5 5 5 5 5 5 5 5 5 5 5 5 5 13 
-
